10
2 2 1 1 1 1 3 1 1 1
8 8 2 2 2 1 1 3 1 1
2 8 8 8 8 2 2 2 3 1
1 2 2 8 8 8 8 8 2 3
0 0 1 2 2 2 8 9 8 2
0 0 0 0 0 0 0 0 0 0
1 1 1 5 6 6 5 2 8 8
1 1 5 6 7 7 6 5 2 8
1 5 6 7 8 7 6 5 2 8
1 5 6 7 8 8 7 6 5 2
2 8
10 5
